64 5
0 1 2 3 4 5 6 6 7 8 6 6 6 6 7 8 6 6 7 8 6 6 1 4 5 7 8 6 7 8 1 2 9 3 2 6 6 7 8 6 6 7 8 6 6 6 6 6 6 6 6 6 6 10 6 7 8 6 6 10 6 6 7 8 
11 12 13 14 14 15 10 6 16 17 18 19 17 19 20 6 6 10 6 6 6 6 12 14 15 6 6 6 6 6 12 13 13 14 13 15 10 6 6 6 6 6 6 10 6 6 21 22 7 8 16 17 19 23 16 18 17 19 20 7 8 6 6 6 
24 25 26 27 27 28 29 30 31 31 31 32 31 32 33 34 35 36 37 38 39 40 25 27 28 6 21 41 41 22 25 26 26 27 26 28 29 35 42 6 21 41 22 6 6 42 43 44 29 30 31 31 32 31 32 31 31 32 33 35 36 37 39 38 
45 46 46 46 46 46 46 46 46 46 46 46 46 46 46 46 46 46 46 46 46 46 46 46 46 42 43 47 47 44 46 46 46 46 46 46 46 46 48 46 43 47 44 46 42 48 43 44 46 46 46 46 46 46 46 46 46 46 46 46 46 46 46 46 
49 50 50 50 50 50 50 50 50 50 50 50 50 50 50 50 51 52 53 52 53 52 53 52 53 54 55 56 56 57 52 52 58 59 52 60 50 50 50 50 50 50 50 51 54 54 55 57 52 52 61 52 61 52 61 52 60 50 50 50 50 50 50 50 
