238 5 63
0 1 2 3 4 5 6 6 7 8 9 10 11 10 12 13 14 6 12 13 14 6 15 16 5 12 13 14 12 13 17 18 19 20 21 22 6 12 13 14 6 12 13 14 6 23 24 25 26 6 27 28 29 30 31 32 8 33 34 35 14 6 12 
36 37 38 39 40 41 42 43 44 45 46 47 48 49 50 51 52 53 54 55 56 57 58 59 60 61 62 63 64 65 66 67 68 69 70 71 42 72 73 74 75 64 76 77 78 79 80 81 82 83 84 85 86 87 88 89 90 49 91 92 93 94 95 
96 97 98 99 100 101 102 103 104 105 106 107 108 109 110 111 112 113 114 115 116 117 118 119 120 121 80 122 122 123 124 125 126 127 128 129 130 131 132 133 134 122 135 136 137 138 139 140 141 142 104 143 144 145 146 147 148 109 110 149 150 151 152 
153 154 155 156 157 158 159 160 161 161 162 163 164 163 165 166 167 168 169 170 171 172 173 174 175 176 139 177 177 178 179 180 181 182 183 184 185 186 187 188 189 190 191 192 193 194 195 178 196 197 198 199 200 201 200 202 203 163 165 204 205 206 207 
208 209 210 210 210 210 210 210 210 210 210 210 210 210 210 210 211 212 213 214 213 214 213 214 215 216 217 218 218 219 220 221 222 223 224 225 210 226 227 228 229 230 231 232 233 234 217 219 220 235 236 235 236 235 236 237 225 210 210 210 210 210 210 
