96 5
0 0 0 0 0 0 0 0 1 2 0 0 0 0 0 1 2 0 0 0 0 3 0 0 0 0 0 0 0 1 2 0 0 0 0 0 0 3 0 0 0 0 1 2 0 0 0 0 0 1 2 0 0 0 0 0 4 0 0 0 0 0 0 0 1 2 0 0 0 3 0 0 0 0 0 4 0 0 0 0 0 0 0 0 0 0 0 1 2 0 0 0 0 3 0 5 
0 4 0 0 3 0 0 0 0 0 0 3 0 0 0 0 0 0 6 7 7 7 8 0 4 0 0 3 0 0 0 0 0 0 9 7 8 0 6 7 10 0 0 0 0 0 3 0 0 0 6 7 7 7 8 0 1 2 0 9 8 0 0 0 0 0 0 0 0 0 0 4 0 0 0 1 2 0 0 0 0 0 1 2 0 0 0 0 0 0 0 4 0 0 0 5 
0 1 2 0 0 0 4 0 0 0 0 0 0 6 7 7 7 7 11 12 12 12 13 0 1 2 0 0 0 14 0 3 0 15 16 12 13 0 5 12 17 18 7 7 7 7 7 7 7 7 11 12 12 12 13 0 0 0 15 16 13 0 0 0 0 0 0 6 7 8 0 1 2 0 0 0 0 0 0 3 0 0 0 0 0 6 7 7 7 8 0 1 2 0 0 19 
0 0 0 0 0 0 1 2 6 7 7 7 7 11 12 12 12 12 12 12 12 12 13 0 0 0 0 14 0 20 0 0 0 0 21 12 12 0 12 12 22 23 12 12 12 12 22 23 12 12 12 12 12 12 24 25 26 25 25 16 13 25 14 26 6 7 7 11 12 13 0 0 0 6 10 0 0 0 6 7 10 0 0 6 7 11 12 12 12 13 0 0 0 0 0 27 
7 7 7 7 7 7 7 7 11 12 12 12 12 12 12 12 12 12 12 12 12 12 13 26 25 14 25 20 25 5 18 7 7 7 11 12 22 28 23 12 12 12 12 22 23 12 12 12 12 22 28 28 23 13 29 29 29 14 29 21 13 29 20 29 5 12 12 12 12 17 18 7 7 11 17 18 7 7 11 12 17 18 7 11 12 12 12 12 12 13 26 25 6 7 7 30 
